Account.Id,EVT,FT,NA,NULL,PT,TotalComplaints
55621,0,32,4,23,0,59
66495,0,26,0,15,0,41
63225,0,6,0,12,0,18
18785,0,12,0,12,0,24
40336,0,111,0,12,3,126
35419,0,84,0,12,0,96
35435,0,36,0,10,0,46
21422,0,20,0,10,0,30
28951,0,33,0,9,0,42
51547,0,48,1,8,0,57
66527,0,14,0,7,0,21
67797,0,0,0,7,0,7
46287,0,7,0,6,0,13
41699,0,22,0,6,0,28
20559,0,3,0,6,0,9
35670,0,0,0,6,0,6
67796,0,0,0,5,0,5
67031,0,3,0,5,0,8
60623,0,10,0,5,0,15
67798,0,2,0,5,0,7
19826,0,4,0,5,0,9
35746,0,27,3,5,0,35
35393,0,6,0,5,0,11
30750,0,14,4,5,0,23
47374,0,9,0,4,0,13
54463,0,26,6,4,0,36
59121,0,4,1,4,0,9
45868,0,11,0,4,0,15
13967,0,0,0,4,0,4
35392,0,6,0,4,0,10
39188,0,16,0,4,0,20
41736,0,17,0,4,0,21
46291,0,4,1,4,0,9
20689,0,0,0,4,0,4
40555,0,0,0,4,0,4
41356,0,0,0,4,0,4
15004,0,32,0,4,0,36
66491,0,38,0,3,0,41
66050,0,1,0,3,0,4
61112,0,2,1,3,0,6
64337,0,1,0,3,0,4
66123,0,5,0,3,0,8
58904,0,1,0,3,0,4
66492,0,35,0,3,0,38
64516,0,0,0,3,0,3
66030,0,36,0,3,7,46
59254,0,4,1,3,0,8
45017,0,3,0,3,0,6
20950,0,17,0,3,0,20
45633,0,1,0,3,0,4
46300,0,0,0,3,0,3
35395,0,29,0,3,0,32
55041,0,4,0,2,0,6
67011,0,2,0,2,0,4
50537,0,0,0,2,0,2
59453,0,0,0,2,0,2
67034,0,3,0,2,0,5
65734,0,11,0,2,0,13
64137,0,2,0,2,0,4
59673,0,6,0,2,0,8
58015,0,2,0,2,0,4
59700,0,1,1,2,0,4
59785,0,0,0,2,0,2
67799,0,0,0,2,0,2
60500,0,14,0,2,0,16
66458,0,15,0,2,0,17
64478,0,0,0,2,0,2
62387,0,51,0,2,0,53
17130,0,20,0,2,0,22
36644,0,15,0,2,0,17
20694,0,30,0,2,0,32
22530,0,50,0,2,0,52
37416,0,0,0,2,0,2
27839,0,8,0,2,0,10
18756,0,7,0,2,0,9
28965,22,4,0,2,0,28
46687,0,10,0,2,0,12
17099,0,6,0,2,0,8
36664,0,5,0,2,0,7
35544,0,12,0,2,0,14
38819,0,5,0,2,0,7
35552,0,20,0,2,0,22
18509,0,20,0,2,0,22
35659,0,0,0,2,0,2
41392,0,0,0,2,0,2
35714,0,7,0,2,0,9
46301,0,3,0,2,0,5
17118,0,2,0,2,0,4
36414,0,8,0,2,0,10
36500,0,56,0,2,1,59
67597,0,0,0,1,0,1
66485,0,17,0,1,0,18
51483,0,0,0,1,0,1
54781,0,12,1,1,0,14
66660,0,49,0,1,0,50
59824,0,2,0,1,0,3
65644,0,1,0,1,0,2
59941,0,4,0,1,0,5
58463,0,0,0,1,0,1
60025,0,3,0,1,0,4
59200,0,0,0,1,0,1
50343,0,0,0,1,0,1
52472,0,0,0,1,0,1
55490,0,0,0,1,0,1
49952,0,1,0,1,0,2
60647,0,8,0,1,0,9
65764,0,15,0,1,0,16
60847,0,12,0,1,0,13
66062,0,0,0,1,0,1
55604,0,0,0,1,0,1
66273,0,10,0,1,0,11
61230,0,4,0,1,0,5
49209,0,1,0,1,0,2
61308,0,0,0,1,0,1
66517,0,1,0,1,0,2
62203,0,5,2,1,0,8
66884,0,9,0,1,0,10
48925,0,0,0,1,0,1
59628,0,0,0,1,0,1
55656,0,1,0,1,0,2
59644,0,0,0,1,0,1
62652,0,5,0,1,0,6
65415,0,8,0,1,0,9
55880,0,3,0,1,0,4
57962,0,3,0,1,0,4
63350,0,8,0,1,0,9
65940,0,32,0,1,0,33
63382,0,1,0,1,0,2
58202,0,5,0,1,0,6
63449,0,9,0,1,0,10
66109,0,5,0,1,0,6
55884,0,0,0,1,0,1
66268,0,8,0,1,0,9
56006,0,0,0,1,0,1
58850,0,9,1,1,0,11
56209,0,2,0,1,0,3
66486,0,31,0,1,0,32
57920,0,5,0,1,0,6
51815,0,5,1,1,1,8
64546,0,1,0,1,0,2
66497,0,8,0,1,0,9
64607,0,0,0,1,0,1
59240,0,3,0,1,0,4
64615,0,3,0,1,0,4
66750,0,0,0,1,0,1
64618,0,1,0,1,0,2
66885,0,20,0,1,0,21
64619,0,0,0,1,0,1
52530,0,2,0,1,0,3
64626,0,2,0,1,0,3
67240,0,1,0,1,0,2
64780,0,7,0,1,0,8
67635,0,11,0,1,0,12
64793,0,7,0,1,2,10
54166,0,20,1,1,0,22
64850,0,5,0,1,2,8
65329,0,4,0,1,0,5
62497,0,0,1,1,0,2
60524,0,0,0,1,0,1
35357,0,24,1,1,0,26
46534,0,34,0,1,0,35
20612,0,0,0,1,0,1
21648,0,6,0,1,0,7
40390,0,2,0,1,0,3
35526,0,1,7,1,0,9
45071,0,6,0,1,0,7
21884,0,0,0,1,0,1
17074,0,0,1,1,0,2
20866,0,1,1,1,0,3
40258,0,0,0,1,0,1
35582,0,1,0,1,0,2
40930,0,27,0,1,0,28
15008,0,2,0,1,0,3
19049,0,1,0,1,0,2
17109,0,11,0,1,0,12
45326,0,0,0,1,0,1
35693,0,3,0,1,0,4
46281,0,0,0,1,0,1
27881,0,5,0,1,0,6
17084,0,1,0,1,0,2
28898,0,7,0,1,0,8
46694,0,3,0,1,0,4
35836,0,1,0,1,0,2
17071,0,0,0,1,0,1
28916,0,0,0,1,0,1
32851,0,1,0,1,0,2
20852,0,2,0,1,0,3
18773,0,5,0,1,0,6
28944,0,3,0,1,0,4
13483,0,0,0,1,0,1
17070,0,4,0,1,0,5
13984,0,0,0,1,0,1
36918,0,4,1,1,0,6
45268,0,1,0,1,0,2
15273,0,8,1,1,0,10
14013,0,1,0,1,0,2
38261,0,2,0,1,0,3
46186,0,4,0,1,0,5
30138,0,0,0,1,0,1
13908,0,1,0,1,0,2
38910,0,4,0,1,0,5
20849,0,0,0,1,0,1
30749,0,0,0,1,0,1
46319,0,3,0,1,0,4
39407,0,1,0,1,0,2
46723,0,2,0,1,0,3
39477,0,0,0,1,0,1
17095,0,5,0,1,0,6
39805,0,0,0,1,0,1
33567,0,3,0,1,0,4
57860,0,4,0,0,0,4
65474,0,2,0,0,0,2
53617,0,3,0,0,0,3
57938,0,7,0,0,0,7
66317,0,1,0,0,0,1
57939,0,1,0,0,0,1
52983,0,1,0,0,0,1
57940,0,3,0,0,0,3
64739,0,12,0,0,0,12
57943,0,7,1,0,0,8
55380,0,2,0,0,0,2
57948,0,10,0,0,0,10
66661,22,0,0,0,0,22
57949,0,2,5,0,0,7
57934,0,1,0,0,0,1
57951,0,5,1,0,0,6
63734,0,7,0,0,0,7
57955,0,9,1,0,0,10
64586,0,8,0,0,0,8
57956,0,8,0,0,0,8
48921,0,2,0,0,0,2
49407,0,1,0,0,0,1
65854,0,5,0,0,0,5
57995,0,1,0,0,0,1
66164,0,2,0,0,0,2
57996,0,1,0,0,0,1
66493,0,45,0,0,0,45
57998,0,4,0,0,0,4
66991,0,1,0,0,0,1
58001,0,14,0,0,0,14
57921,0,6,0,0,0,6
58009,0,10,0,0,0,10
63226,0,8,0,0,0,8
58010,0,14,2,0,0,16
63394,0,15,0,0,0,15
58013,0,1,0,0,0,1
64017,0,1,0,0,0,1
58014,0,14,0,0,0,14
64493,0,26,0,0,0,26
49417,0,0,2,0,0,2
54324,0,6,1,0,0,7
58020,0,14,1,0,0,15
64781,0,2,0,0,0,2
58124,0,4,0,0,0,4
65328,0,2,0,0,0,2
58194,0,12,0,0,0,12
54526,0,6,0,0,0,6
49442,0,2,0,0,0,2
65977,0,2,0,0,0,2
58283,0,4,0,0,0,4
66124,0,8,0,0,0,8
58327,0,3,0,0,0,3
48966,0,3,0,0,0,3
58349,0,1,0,0,0,1
66487,0,1,0,0,0,1
58412,0,1,0,0,0,1
49073,0,1,0,0,0,1
58438,0,6,0,0,0,6
56183,0,1,0,0,0,1
58454,0,1,0,0,0,1
56226,0,1,0,0,0,1
58456,0,2,0,0,0,2
67700,0,2,0,0,0,2
49626,0,1,0,0,0,1
67881,0,2,0,0,0,2
58750,0,5,0,0,0,5
63167,0,2,0,0,0,2
49675,0,2,0,0,0,2
63315,0,6,0,0,0,6
58855,0,3,1,0,0,4
63381,0,9,0,0,0,9
58860,0,7,0,0,0,7
63447,0,3,0,0,0,3
58903,0,1,0,0,0,1
63854,0,1,0,0,0,1
49716,0,1,0,0,0,1
64071,0,3,0,0,0,3
58962,0,0,1,0,0,1
64406,0,3,0,0,0,3
59117,0,3,1,0,0,4
54161,0,1,3,0,0,4
49867,0,1,0,0,0,1
54322,0,2,0,0,0,2
49903,0,1,0,0,0,1
54358,0,6,0,0,0,6
59239,0,3,0,0,0,3
64741,0,5,0,0,0,5
47682,0,3,1,0,0,4
64787,0,10,0,0,0,10
50049,0,1,0,0,0,1
64948,0,7,0,0,7,14
59277,0,3,0,0,0,3
54523,0,1,0,0,0,1
50050,0,0,1,0,0,1
65585,0,3,0,0,0,3
59520,0,19,0,0,0,19
47373,0,2,0,0,0,2
59594,0,2,0,0,0,2
54846,0,0,0,0,1,1
59595,0,3,0,0,0,3
48957,0,3,0,0,0,3
50070,0,26,0,0,0,26
66122,0,2,0,0,1,3
50123,0,3,0,0,0,3
66126,0,37,0,0,0,37
59653,0,3,0,0,0,3
66237,0,16,0,0,0,16
59659,0,1,0,0,0,1
66290,0,12,0,0,0,12
59666,0,5,0,0,0,5
49000,0,1,0,0,0,1
59670,0,1,0,0,0,1
55658,0,1,0,0,0,1
59671,0,3,0,0,0,3
55838,0,1,0,0,0,1
50217,0,3,0,0,0,3
66552,0,1,0,0,0,1
59678,0,1,0,0,0,1
66803,0,22,0,0,0,22
59692,0,6,0,0,0,6
66898,0,3,0,0,0,3
48182,0,1,0,0,0,1
49082,0,1,0,0,0,1
59770,0,1,0,0,0,1
67225,0,4,0,0,0,4
50445,0,30,8,0,0,38
57919,0,1,0,0,0,1
48192,0,5,3,0,0,8
67734,0,1,0,0,0,1
51112,0,1,0,0,0,1
57926,0,1,0,0,0,1
51122,0,1,0,0,0,1
68052,0,3,0,0,0,3
60088,0,2,0,0,0,2
63148,0,23,0,0,0,23
60102,0,14,0,0,0,14
52714,0,8,1,0,0,9
60445,0,1,0,0,0,1
63307,0,1,0,0,0,1
60476,0,1,0,0,0,1
63328,0,2,0,0,0,2
60477,0,1,0,0,0,1
63363,0,1,0,0,0,1
60481,0,2,0,0,0,2
53068,0,1,0,0,0,1
60485,0,4,0,0,0,4
63418,0,7,0,0,0,7
60493,0,5,0,0,0,5
53096,0,1,0,0,0,1
48422,0,5,0,0,0,5
63770,0,1,0,0,0,1
60501,0,4,0,0,0,4
63998,0,1,0,0,0,1
60502,0,1,0,0,0,1
64070,0,9,0,0,0,9
60505,0,1,1,0,0,2
64088,0,7,0,0,0,7
60507,0,5,0,0,0,5
53963,0,1,0,0,0,1
60517,0,1,0,0,0,1
54085,0,1,0,0,0,1
60519,0,2,0,0,0,2
54096,0,20,0,0,0,20
47257,0,0,2,0,16,18
64568,0,2,0,0,0,2
60555,0,2,0,0,0,2
48913,0,36,0,0,0,36
60600,0,8,0,0,0,8
54323,0,1,0,0,0,1
48521,0,7,1,0,0,8
64621,0,1,0,0,0,1
48604,0,2,0,0,0,2
64633,0,9,0,0,0,9
60725,0,20,0,0,0,20
64740,0,3,0,0,0,3
52377,0,7,0,0,0,7
54391,0,4,0,0,0,4
60860,0,2,0,0,0,2
64783,0,35,0,0,8,43
60919,0,0,3,0,0,3
54458,0,6,0,0,0,6
61026,0,10,0,0,0,10
64878,0,2,0,0,0,2
61036,0,0,1,0,0,1
65306,0,2,0,0,2,4
61040,0,5,0,0,0,5
54522,0,12,0,0,0,12
61056,0,5,3,0,0,8
65438,0,6,0,0,0,6
48606,0,1,0,0,0,1
65493,0,3,0,0,0,3
61125,0,2,0,0,0,2
65643,0,3,0,0,0,3
61193,0,3,0,0,0,3
54649,0,3,0,0,0,3
61229,0,2,0,0,0,2
65779,0,1,0,0,0,1
52480,0,2,0,0,0,2
65899,0,9,0,0,0,9
61246,0,1,0,0,0,1
65976,0,8,0,0,0,8
61272,0,1,0,0,0,1
54931,0,0,1,0,0,1
52481,0,2,2,0,0,4
55240,0,2,0,0,0,2
61340,0,1,0,0,0,1
66121,0,2,0,0,0,2
61454,0,5,0,0,0,5
55381,0,3,0,0,0,3
61496,0,10,0,0,0,10
66125,0,10,0,0,0,10
61626,0,6,0,0,0,6
66151,0,7,0,0,0,7
61829,0,4,0,0,0,4
66214,0,3,0,0,0,3
61833,0,4,0,0,0,4
66254,0,1,0,0,0,1
62007,0,1,1,0,0,2
55491,0,1,0,0,0,1
62008,0,2,0,0,0,2
66305,0,2,0,0,0,2
62015,0,2,0,0,0,2
48982,0,0,1,0,0,1
62052,0,9,0,0,0,9
49069,0,1,0,0,0,1
62201,0,1,0,0,0,1
66488,0,2,0,0,0,2
52482,0,1,0,0,0,1
55673,0,4,0,0,0,4
62266,0,2,0,0,0,2
55732,0,2,0,0,0,2
62267,0,3,0,0,0,3
66503,0,1,0,0,0,1
62268,0,4,3,0,0,7
49076,0,2,0,0,0,2
62269,0,16,0,0,0,16
49079,0,1,0,0,0,1
62270,0,18,0,0,0,18
56180,0,4,0,0,0,4
62312,0,4,0,0,0,4
66842,0,5,0,0,0,5
62329,0,9,1,0,0,10
56207,0,1,0,0,0,1
62345,0,2,0,0,0,2
66983,0,1,0,0,0,1
62354,0,7,0,0,0,7
67003,0,13,0,0,0,13
52528,0,1,0,0,0,1
56218,0,3,0,0,5,8
62389,0,4,1,0,0,5
67111,0,1,0,0,0,1
62391,0,1,0,0,0,1
67227,0,21,0,0,0,21
48880,0,1,0,0,0,1
67534,0,13,0,0,0,13
62532,0,3,0,0,0,3
47340,0,1,0,0,0,1
52620,0,3,0,0,0,3
67727,0,5,0,0,0,5
62672,0,3,0,0,0,3
67753,0,5,0,0,0,5
62680,0,1,0,0,0,1
57922,0,1,0,0,0,1
62804,0,18,0,0,0,18
57929,0,16,0,0,0,16
62842,0,4,0,0,0,4
68043,0,7,0,0,0,7
62968,0,1,0,0,0,1
68212,0,6,0,0,0,6
62977,0,1,0,0,0,1
63111,0,2,0,0,0,2
46685,0,6,0,0,0,6
14367,0,5,1,0,0,6
38151,0,13,1,0,0,14
21411,0,3,0,0,0,3
45619,0,1,0,0,0,1
21413,0,3,0,0,0,3
38108,0,7,0,0,0,7
21415,0,2,0,0,0,2
38946,0,2,0,0,0,2
13482,0,1,0,0,0,1
41733,0,1,0,0,0,1
21424,0,1,0,0,0,1
46257,0,4,0,0,0,4
21436,0,3,0,0,0,3
36936,0,1,0,0,0,1
21440,0,1,0,0,0,1
38134,0,1,0,0,0,1
21442,0,2,0,0,0,2
38463,0,8,0,0,0,8
21448,0,9,1,0,0,10
20690,0,2,0,0,0,2
15007,0,6,0,0,0,6
40782,0,1,1,0,0,2
13803,0,5,0,0,0,5
20903,0,1,0,0,0,1
21885,0,3,1,0,0,4
45784,0,0,0,0,1,1
17128,0,3,0,0,0,3
46307,0,3,0,0,0,3
26508,0,2,0,0,0,2
46706,0,2,1,0,0,3
27045,0,4,0,0,0,4
37487,0,1,0,0,0,1
27809,0,1,0,0,0,1
38117,0,27,1,0,0,28
15011,0,5,0,0,0,5
38144,0,5,0,0,0,5
27840,0,2,0,0,0,2
38248,0,1,0,0,0,1
27849,0,27,4,0,0,31
38713,0,3,0,0,0,3
27850,0,45,0,0,0,45
20683,0,2,0,0,0,2
27853,0,1,0,0,0,1
40256,0,2,0,0,0,2
17459,0,2,0,0,0,2
20706,0,3,0,0,0,3
27941,0,30,0,0,0,30
14419,0,6,0,0,0,6
27943,0,1,0,0,0,1
44837,0,4,1,0,0,5
27948,0,1,0,0,0,1
45553,0,3,0,0,0,3
27958,0,0,2,0,0,2
45779,0,7,0,0,0,7
28373,0,2,0,0,0,2
45888,0,2,0,0,0,2
28396,0,12,2,0,0,14
21188,0,7,0,0,0,7
28428,0,5,0,0,0,5
46494,0,11,1,0,0,12
28446,0,1,0,0,0,1
46699,0,0,1,0,0,1
28449,44,0,0,0,0,44
46811,0,2,0,0,0,2
28502,0,1,0,0,0,1
37403,0,1,0,0,0,1
28505,0,1,0,0,0,1
38030,0,2,0,0,0,2
28512,0,2,0,0,0,2
38112,0,4,0,0,0,4
28519,0,4,0,0,0,4
38123,0,26,0,0,0,26
28522,0,1,0,0,0,1
38137,0,2,0,0,0,2
17729,0,1,0,0,0,1
38149,0,5,0,0,0,5
18271,0,3,3,0,0,6
38228,0,1,0,0,0,1
28918,0,12,6,0,0,18
20623,0,1,0,0,0,1
15141,0,0,0,0,1,1
38487,0,2,0,0,0,2
18583,0,5,0,0,0,5
20632,0,9,0,0,0,9
18602,0,1,0,0,0,1
39062,0,2,0,0,0,2
28971,0,0,2,0,0,2
39497,0,1,0,0,0,1
29011,0,4,0,0,0,4
39963,0,13,0,0,0,13
29013,0,4,0,0,0,4
20693,0,7,0,0,0,7
29016,0,13,0,0,0,13
40453,0,2,0,0,0,2
30126,0,8,2,0,0,10
40673,0,13,0,0,0,13
18607,0,1,0,0,0,1
41176,0,5,0,0,0,5
30174,0,1,0,0,0,1
41475,0,2,0,0,0,2
30236,0,2,1,0,0,3
41814,0,8,2,0,0,10
18733,0,1,0,0,0,1
45069,0,2,0,0,0,2
18749,0,1,0,0,0,1
45361,0,7,0,0,0,7
30826,0,2,0,0,0,2
45607,0,0,1,0,0,1
32649,0,36,10,0,0,46
45700,0,0,1,0,0,1
32654,0,2,0,0,0,2
45781,0,3,1,0,0,4
32655,0,1,0,0,4,5
45788,0,2,0,0,0,2
32667,0,3,0,0,0,3
46178,0,6,1,0,0,7
32693,0,2,4,0,0,6
46282,0,6,0,0,0,6
32696,0,186,57,0,0,243
21283,0,2,0,0,0,2
32701,0,6,0,0,0,6
46343,0,12,0,0,0,12
32735,0,1,0,0,0,1
46680,0,1,0,0,0,1
32745,0,1,0,0,0,1
21405,0,28,0,0,0,28
32746,0,2,0,0,0,2
46701,0,2,0,0,0,2
32752,0,4,0,0,0,4
21408,0,5,0,0,1,6
32775,0,4,0,0,0,4
46878,2,0,1,0,9,12
32778,0,5,0,0,0,5
36965,0,2,0,0,0,2
32779,0,1,0,0,0,1
20621,0,1,0,0,0,1
32780,0,3,0,0,0,3
37617,0,1,0,0,0,1
32808,0,12,0,0,0,12
38094,0,20,0,0,0,20
32811,0,2,0,0,0,2
38110,0,1,0,0,0,1
32815,0,1,0,0,0,1
38115,0,1,0,0,0,1
32819,0,6,0,0,0,6
38121,0,1,0,0,0,1
32820,0,1,0,0,0,1
38126,0,4,0,0,0,4
32825,0,10,0,0,0,10
38136,0,4,1,0,0,5
15148,0,1,0,0,0,1
38139,0,7,0,0,0,7
32856,0,3,2,0,0,5
38148,0,2,0,0,0,2
32860,0,5,1,0,0,6
38150,0,3,0,0,0,3
32869,0,1,0,0,0,1
38219,0,2,0,0,0,2
32870,0,4,1,0,0,5
38235,0,1,0,0,0,1
32871,0,2,0,0,0,2
38254,0,1,0,0,0,1
33322,0,3,0,0,0,3
38275,0,2,0,0,0,2
33478,0,2,0,0,0,2
38483,0,1,0,0,0,1
46931,0,4,0,0,0,4
38504,0,2,0,0,0,2
46933,0,9,0,0,0,9
20625,0,0,1,0,0,1
46947,0,1,0,0,0,1
38913,0,36,0,0,0,36
47017,0,2,0,0,0,2
38949,0,5,3,0,0,8
13314,0,2,0,0,0,2
20643,0,3,0,0,0,3
33840,0,0,2,0,0,2
13901,0,1,0,0,0,1
33867,0,5,0,0,0,5
39786,84,0,0,0,0,84
34428,0,1,0,0,0,1
39942,0,2,0,0,0,2
34481,0,1,0,0,0,1
40255,0,11,1,0,0,12
34728,0,1,0,0,0,1
40257,0,3,0,0,0,3
34732,0,1,0,0,0,1
40284,0,3,0,0,0,3
34741,0,1,0,0,0,1
20701,0,3,0,0,0,3
34792,0,2,0,0,0,2
40537,0,6,0,0,0,6
35242,0,4,0,0,0,4
40562,0,1,0,0,0,1
15153,0,17,1,0,0,18
40779,0,18,0,0,0,18
18780,0,16,2,0,0,18
20717,0,1,0,0,0,1
13896,0,1,0,0,0,1
20848,0,1,0,0,0,1
15314,0,1,0,0,0,1
41398,0,1,0,0,0,1
19597,0,2,0,0,0,2
17077,0,1,0,0,0,1
35427,0,18,0,0,0,18
20861,0,4,0,0,0,4
15317,0,2,0,0,0,2
44812,0,12,0,0,0,12
20054,0,1,0,0,0,1
14449,0,0,2,0,0,2
20335,0,2,0,0,0,2
20868,0,1,0,0,0,1
35546,0,10,0,0,0,10
20904,0,1,1,0,0,2
20337,0,1,0,0,0,1
45456,0,1,0,0,0,1
35562,0,2,0,0,0,2
45555,0,1,0,0,0,1
20345,0,2,0,0,0,2
45618,0,4,0,0,0,4
35596,0,12,0,0,0,12
20923,0,3,0,0,0,3
20347,0,1,0,0,0,1
45778,0,14,1,0,0,15
20351,0,2,0,0,0,2
45780,0,10,0,0,0,10
35681,0,2,0,0,0,2
45783,0,4,0,0,0,4
20484,0,6,0,0,0,6
45785,0,8,0,0,0,8
35697,0,7,0,0,0,7
14531,0,3,1,0,0,4
35703,0,2,0,0,0,2
46033,0,0,2,0,6,8
20556,0,3,0,0,0,3
20955,0,1,0,0,0,1
16641,0,0,2,0,0,2
21006,0,1,0,0,0,1
35749,0,1,0,0,0,1
21031,0,4,0,0,0,4
35775,0,32,0,0,0,32
46299,0,2,0,0,0,2
20571,0,28,6,0,0,34
21392,0,4,0,0,0,4
35902,0,42,0,0,0,42
21394,0,10,3,0,0,13
20584,0,2,0,0,0,2
46426,0,2,0,0,0,2
20586,0,5,0,0,0,5
21398,0,12,0,0,0,12
36501,0,1,0,0,0,1
46684,0,1,0,0,0,1
36607,0,0,1,0,0,1
21399,0,4,0,0,0,4
36612,0,18,0,0,0,18
46697,0,2,0,0,0,2
36628,0,3,0,0,0,3
46700,0,4,0,0,0,4
36629,0,1,1,0,0,2
46704,0,3,0,0,0,3
20588,0,2,0,0,1,3
46707,0,1,0,0,0,1
17067,0,3,0,0,0,3
46776,0,1,0,0,0,1
36756,0,3,0,0,0,3
46853,0,5,0,0,0,5
36779,0,2,0,0,0,2
21409,0,4,0,0,0,4
20618,0,1,0,0,0,1
46934,0,18,8,0,0,26
33829,0,4,1,0,0,5
46968,0,3,0,0,0,3
33830,0,1,0,0,0,1
47255,0,34,8,0,42,84
33833,0,2,0,0,0,2
33839,0,3,0,0,0,3
